{
	"width": 13,
	"height": 11,
	"tiles": [
		[1,1,1,1,1,1,1,1,1,1,1],
		[1,9,0,2,2,2,2,2,0,12,1],
		[1,0,1,2,1,2,1,2,1,0,1],
		[1,2,2,2,2,2,2,2,2,2,1],
		[1,2,1,2,1,2,1,2,1,2,1],
		[1,2,2,2,2,2,2,2,2,2,1],
		[1,2,1,2,1,2,1,2,1,2,1],
		[1,2,2,2,2,2,2,2,2,2,1],
		[1,2,1,2,1,2,1,2,1,2,1],
		[1,2,2,2,2,2,2,2,2,2,1],
		[1,0,1,2,1,2,1,2,1,0,1],
		[1,11,0,2,2,2,2,2,0,10,1],
		[1,1,1,1,1,1,1,1,1,1,1]
	]
}
