{
	"width": 13,
	"height": 11,
	"tiles": [
		[1,1,1,1,1,1,1,1,1,1,1],
		[1,9,0,4,4,4,4,4,0,12,1],
		[1,0,1,4,1,4,1,4,1,0,1],
		[1,4,4,4,4,4,4,4,4,4,1],
		[1,4,1,4,1,4,1,4,1,4,1],
		[1,4,4,4,4,4,4,4,4,4,1],
		[1,4,1,4,1,4,1,4,1,4,1],
		[1,4,4,4,4,4,4,4,4,4,1],
		[1,4,1,4,1,4,1,4,1,4,1],
		[1,4,4,4,4,4,4,4,4,4,1],
		[1,0,1,4,1,4,1,4,1,0,1],
		[1,11,0,4,4,4,4,4,0,10,1],
		[1,1,1,1,1,1,1,1,1,1,1]
	]
}
